0 X X X X X X X
0 0 D D 0 X 0 X
0 0 0 0 0 0 F X
0 0 0 D 0 D D X
X D X 0 0 X 0 X
0 0 0 0 D 0 0 X
X X F X X X X X